11 11
-1 -1 -1 -1 -1 -1 -1 -1 -1 -1 -1
-1 00 00 00 00 00 00 00 00 00 -1
-1 00 00 00 00 00 00 00 00 00 -1
-1 00 00 00 00 00 00 00 00 00 -1
-1 00 02 02 00 00 00 00 00 00 -1
-1 01 01 01 00 00 00 00 00 00 -1
-1 00 01 00 00 00 00 00 00 00 -1
-1 00 00 00 00 00 00 00 00 00 -1
-1 00 00 00 00 00 00 00 00 00 -1
-1 00 00 00 00 00 00 00 00 00 -1
-1 -1 -1 -1 -1 -1 -1 -1 -1 -1 -1 